30.ox
...o..........................
..............................
.o.........o......o...........
.o...o.........o.......o......
oo.......o...o.......o.o....o.
..............................
..............................
...........o..................
.............o..o.......o.....
........oo.........oooo.o.....
....o....o......o.o..o........
......o...o...................
.o............................ 
..........o....o...o.o........
..........o.....o.............
...o.o......o..............o..
...o....................o.....
..............o....o..o.......
.......oo...............o...o.
.......................o.o....
...o.......o...............o..
..o...............aaaaaaaaaaa.......o....
.........o...o...........o....
..........o..o................
..............................
........o.....................
..........o...o...o...........
oo..................o.........
.......o.......o......oo......
.o............oo.....o........ 